20
132																														             
R R R R R RR        A         A           A               A            A                A                A                         
RRFFR  RFFRR                                                                                                                   	   
RRFFR  RFFRR        AAAAAAAAAAAAAAAAAAAAAAAAAAAAAAAAAAAAAAAAAAAAAAAAAAAAAAAAAAAAAAAAAAAAAAAAAAAAAAAAAAAAAAAAAAAAAAAAAAAAAAAAAAAAAAAA
RRFFR  RFFRR               FFFFFFFFFFF                                                                                         	   
RRFFR  RFFRR               FFFFFFFFFFF            A      A        A           A                   A                                
RRFFR  RFFRR               RRRRRRRRRRR                                                                                         	   
RRFFRRRRFFRR                                                                                                                   	   
RRFFRRRRFFRR            RR                                                                                                     	   
RRFFRRRRFFRR                        t  t  t  t      t  t  t  t  t  t  t                                                        	   
RRFFRRRRFFRR                         RR RR RR RR     RR RR RR RR RR RR RR                                                      	   
RRRRRRRRRRRR                R       HRRRRRRRRRRR     RRRRRRRRRRRRRRRRRRRR                                                      	   
RRRRRRRRRRRR       RR      HRRRRRRRRRRRRRRRRRRRR	 R  RR  RR  RR  RR  RRRR   H H H H H H H H       R     H       H       H       
RRRRRRRRRRRR      HRRRRRRRRRRRRRRRRRRRFFRRFFRRRR	 RRRRRRRRRRRRRRRRRRRRRRRRRRRRRRRRRRRRRRRRRRRRRRRRR    RRR     RRR     RRR   RRR
RRRRRRRRRRRRRRRRRRRRRRRRRRRRRRRRRRRRRRRRRRRRRRRR	 R  RR  RR  RR  RR  RRRRRRRRRRRRRRRRRRRRRRRRRRRRRR	  RRR     RRR     RRR   RRR
RRRRRRRRRRRRRRRRRRRRRRRRRRRRRRRRRRRRRRFFRRFFRRRR	 RRRRRRRRRRRRRRRRRRRRRRRRRRRRRRRRRRRRRRRRRRRRRRRRR	  RRR     RRR     RRR   RRR
RRRRRRRRRRRRRRRRRRRRRRRRRRRRRRRRRRRRRRRRRRRRRRRR	 RRRRRRRRRRRRRRRRRRRRRRRRRRRRRRRRRRRRRRRRRRRRRRRRR	  RRR     RRR     RRR   RRR
RRRRRRRRRRRRRRRRRRRRRRRRRRRRRRRRRRRRRRRRRRRRRRRR     RRRRRRRRRRRRRRRRRRRRRRRRRRRRRRRRRRRRRRRRRRRRRRRRR    RRR     RRR     RRR   RRR
RRRRRRRRRRRRRRRRRRRRRRRRRRRRRRRRRRRRRRRRRRRRRRRR     RRRRRRRRRRRRRRRRRRRRRRRRRRRRRRRRRRRRRRRRRRRRRRRRR    RRR     RRR     RRR   RRR
RRRRRRRRRRRRRRRRRRRRRRRRRRRRRRRRRRRRRRRRRRRRRRRR     RRRRRRRRRRRRRRRRRRRRRRRRRRRRRRRRRRRRRRRRRRRRRRRRR    RRR     RRR     RRR   RRR
RRRRRRRRRRRRRRRRRRRRRRRRRRRRRRRRRRRRRRRRRRRRRRRR     RRRRRRRRRRRRRRRRRRRRRRRRRRRRRRRRRRRRRRRRRRRRRRRRR    RRR     RRR     RRR   RRR

